...1,...2,...3,被保護世帯数,...5,...6,被保護実人員,...8,...9,保護開始,保護廃止,year_month
全国,NA,NA,1636827,1629260,7567,2053606,2043458,10148,16036,16241,2020-07-01
NA,北海道,NA,47636,47550,86,60393,60291,102,389,435,2020-07-01
NA,青森,NA,13571,13533,38,16370,16324,46,105,110,2020-07-01
NA,岩手,NA,6654,6625,29,8246,8208,38,87,59,2020-07-01
NA,宮城,NA,8555,8508,47,11028,10957,71,114,84,2020-07-01
NA,秋田,NA,6786,6751,35,8477,8432,45,58,80,2020-07-01
NA,山形,NA,4791,4739,52,5761,5686,75,56,64,2020-07-01
NA,福島,NA,5405,5369,36,6557,6519,38,74,68,2020-07-01
NA,茨城,NA,18628,18541,87,22797,22680,117,217,183,2020-07-01
NA,栃木,NA,9732,9679,53,11784,11706,78,105,84,2020-07-01
NA,群馬,NA,6200,6172,28,7302,7272,30,62,72,2020-07-01
NA,埼玉,NA,44817,44644,173,57038,56795,243,492,415,2020-07-01
NA,千葉,NA,41318,41146,172,52148,51921,227,418,407,2020-07-01
NA,東京,NA,224520,223592,928,273963,272683,1280,2094,2215,2020-07-01
NA,神奈川,NA,27656,27521,135,35259,35064,195,320,307,2020-07-01
NA,新潟,NA,7040,6984,56,8718,8632,86,75,64,2020-07-01
NA,富山,NA,1414,1387,27,1592,1558,34,18,20,2020-07-01
NA,石川,NA,2563,2527,36,2961,2917,44,29,25,2020-07-01
NA,福井,NA,1380,1361,19,1601,1577,24,19,20,2020-07-01
NA,山梨,NA,3371,3334,37,4145,4097,48,39,40,2020-07-01
NA,長野,NA,6363,6315,48,7721,7657,64,88,81,2020-07-01
NA,岐阜,NA,4473,4418,55,5436,5372,64,60,59,2020-07-01
NA,静岡,NA,12555,12469,86,15204,15076,128,181,164,2020-07-01
NA,愛知,NA,17804,17675,129,22412,22236,176,258,216,2020-07-01
NA,三重,NA,12597,12515,82,15605,15487,118,156,131,2020-07-01
NA,滋賀,NA,5195,5167,28,7017,6974,43,50,60,2020-07-01
NA,京都,NA,10034,9979,55,13751,13664,87,89,102,2020-07-01
NA,大阪,NA,40632,40496,136,52976,52795,181,380,404,2020-07-01
NA,兵庫,NA,13918,13832,86,17961,17849,112,143,145,2020-07-01
NA,奈良,NA,9043,8979,64,11756,11672,84,48,77,2020-07-01
NA,和歌山,NA,4808,4780,28,5780,5744,36,54,50,2020-07-01
NA,鳥取,NA,3212,3195,17,3905,3884,21,43,45,2020-07-01
NA,島根,NA,2378,2374,4,2917,2913,4,23,29,2020-07-01
NA,岡山,NA,3533,3514,19,4287,4262,25,32,51,2020-07-01
NA,広島,NA,5601,5566,35,7251,7196,55,44,55,2020-07-01
NA,山口,NA,8332,8299,33,10131,10092,39,83,83,2020-07-01
NA,徳島,NA,10397,10354,43,12931,12876,55,83,79,2020-07-01
NA,香川,NA,3242,3218,24,4022,3993,29,23,55,2020-07-01
NA,愛媛,NA,7543,7439,104,9090,8948,142,67,90,2020-07-01
NA,高知,NA,5676,5630,46,6926,6866,60,48,68,2020-07-01
NA,福岡,NA,37142,37012,130,49815,49607,208,266,272,2020-07-01
NA,佐賀,NA,6496,6445,51,7722,7664,58,74,73,2020-07-01
NA,長崎,NA,7781,7745,36,9856,9812,44,66,67,2020-07-01
NA,熊本,NA,7501,7464,37,9343,9298,45,89,95,2020-07-01
NA,大分,NA,9016,8929,87,10958,10840,118,65,94,2020-07-01
NA,宮崎,NA,7379,7355,24,9070,9032,38,81,78,2020-07-01
NA,鹿児島,NA,11702,11562,140,14863,14677,186,92,117,2020-07-01
NA,沖縄,NA,19804,19720,84,25008,24876,132,242,225,2020-07-01
指定都市（別掲）,NA,NA,NA,NA,NA,NA,NA,NA,NA,NA,2020-07-01
NA,札幌市,NA,55582,55369,213,71493,71218,275,634,624,2020-07-01
NA,仙台市,NA,14199,14106,93,18360,18234,126,143,142,2020-07-01
NA,さいたま市,NA,15508,15459,49,19681,19613,68,171,157,2020-07-01
NA,千葉市,NA,17168,16987,181,21015,20766,249,247,210,2020-07-01
NA,横浜市,NA,54574,54482,92,69015,68892,123,626,653,2020-07-01
NA,川崎市,NA,23811,23780,31,29984,29941,43,273,275,2020-07-01
NA,相模原市,NA,10459,10428,31,13742,13702,40,115,89,2020-07-01
NA,新潟市,NA,9262,9222,40,11842,11787,55,91,100,2020-07-01
NA,静岡市,NA,7450,7384,66,9334,9243,91,92,74,2020-07-01
NA,浜松市,NA,5686,5638,48,7117,7061,56,71,50,2020-07-01
NA,名古屋市,NA,38633,38410,223,47523,47258,265,541,562,2020-07-01
NA,京都市,NA,32167,31779,388,42124,41583,541,278,318,2020-07-01
NA,大阪市,NA,112923,112441,482,135281,134680,601,1146,1164,2020-07-01
NA,堺市,NA,19361,19323,38,25066,25014,52,222,212,2020-07-01
NA,神戸市,NA,34015,33859,156,44345,44148,197,285,323,2020-07-01
NA,岡山市,NA,9857,9828,29,12853,12813,40,82,93,2020-07-01
NA,広島市,NA,18485,18422,63,23933,23849,84,165,178,2020-07-01
NA,北九州市,NA,18352,18268,84,22734,22637,97,114,162,2020-07-01
NA,福岡市,NA,33649,33524,125,42662,42495,167,325,353,2020-07-01
NA,熊本市,NA,11916,11888,28,14984,14948,36,136,110,2020-07-01
中核市　（別掲）,NA,NA,NA,NA,NA,NA,NA,NA,NA,NA,2020-07-01
NA,旭川市,NA,9930,9889,41,12291,12244,47,82,92,2020-07-01
NA,函館市,NA,9330,9310,20,11542,11518,24,69,77,2020-07-01
NA,青森市,NA,6766,6763,3,8320,8317,3,58,53,2020-07-01
NA,八戸市,NA,3473,3461,12,4248,4234,14,24,25,2020-07-01
NA,盛岡市,NA,3826,3812,14,4611,4591,20,28,37,2020-07-01
NA,秋田市,NA,4296,4288,8,5305,5285,20,32,44,2020-07-01
NA,山形市,NA,1781,1763,18,2167,2148,19,19,17,2020-07-01
NA,郡山市,NA,2686,2682,4,3250,3246,4,35,28,2020-07-01
NA,いわき市,NA,3331,3324,7,4271,4261,10,36,39,2020-07-01
NA,福島市,NA,2533,2531,2,3094,3092,2,32,33,2020-07-01
NA,水戸市,NA,4062,4033,29,5186,5150,36,41,33,2020-07-01
NA,宇都宮市,NA,6691,6659,32,8282,8240,42,51,55,2020-07-01
NA,前橋市,NA,3432,3398,34,4145,4093,52,33,37,2020-07-01
NA,高崎市,NA,2899,2879,20,3442,3416,26,22,21,2020-07-01
NA,川越市,NA,3436,3432,4,4387,4378,9,37,30,2020-07-01
NA,越谷市,NA,3358,3342,16,4381,4360,21,39,35,2020-07-01
NA,川口市,NA,9025,9009,16,11539,11515,24,93,54,2020-07-01
NA,船橋市,NA,7181,7150,31,9078,9039,39,47,66,2020-07-01
NA,柏市,NA,3748,3738,10,4739,4729,10,32,22,2020-07-01
NA,八王子市,NA,7454,7444,10,9386,9375,11,50,50,2020-07-01
NA,横須賀市,NA,4086,4056,30,5204,5161,43,44,36,2020-07-01
NA,富山市,NA,1915,1910,5,2197,2192,5,30,16,2020-07-01
NA,金沢市,NA,3523,3502,21,4054,4027,27,17,16,2020-07-01
NA,福井市,NA,2088,2067,21,2585,2560,25,31,35,2020-07-01
NA,甲府市,NA,2354,2338,16,2836,2815,21,22,25,2020-07-01
NA,長野市,NA,2639,2609,30,3283,3231,52,37,23,2020-07-01
NA,岐阜市,NA,5168,5133,35,6201,6153,48,40,35,2020-07-01
NA,豊橋市,NA,1724,1714,10,2047,2035,12,16,10,2020-07-01
NA,豊田市,NA,1766,1757,9,2357,2343,14,28,20,2020-07-01
NA,岡崎市,NA,1670,1662,8,2103,2092,11,37,9,2020-07-01
NA,大津市,NA,3019,3009,10,3886,3873,13,31,30,2020-07-01
NA,高槻市,NA,4238,4231,7,5725,5716,9,28,26,2020-07-01
NA,東大阪市,NA,13983,13940,43,17909,17853,56,109,121,2020-07-01
NA,豊中市,NA,7525,7500,25,9717,9683,34,49,62,2020-07-01
NA,枚方市,NA,5721,5691,30,7531,7475,56,36,34,2020-07-01
NA,八尾市,NA,5919,5916,3,7744,7741,3,51,58,2020-07-01
NA,寝屋川市,NA,5470,5441,29,7170,7127,43,58,41,2020-07-01
NA,吹田市,NA,4300,4298,2,5611,5609,2,35,30,2020-07-01
NA,姫路市,NA,6646,6629,17,8265,8245,20,51,49,2020-07-01
NA,西宮市,NA,5941,5884,57,7847,7753,94,36,43,2020-07-01
NA,尼崎市,NA,13725,13703,22,17524,17496,28,97,106,2020-07-01
NA,明石市,NA,3914,3897,17,5128,5104,24,31,44,2020-07-01
NA,奈良市,NA,5421,5364,57,7215,7121,94,38,28,2020-07-01
NA,和歌山市,NA,7443,7414,29,8977,8940,37,65,70,2020-07-01
NA,鳥取市,NA,2171,2152,19,2852,2830,22,9,24,2020-07-01
NA,松江市,NA,2064,2052,12,2647,2635,12,21,23,2020-07-01
NA,倉敷市,NA,5337,5326,11,7130,7114,16,55,61,2020-07-01
NA,福山市,NA,4771,4757,14,6103,6087,16,41,47,2020-07-01
NA,呉市,NA,2749,2717,32,3450,3398,52,15,22,2020-07-01
NA,下関市,NA,3182,3167,15,3883,3863,20,25,26,2020-07-01
NA,高松市,NA,4956,4913,43,6216,6161,55,49,37,2020-07-01
NA,松山市,NA,9589,9573,16,11533,11515,18,47,69,2020-07-01
NA,高知市,NA,8883,8843,40,11245,11190,55,58,56,2020-07-01
NA,久留米市,NA,5207,5193,14,6550,6533,17,42,37,2020-07-01
NA,長崎市,NA,9408,9356,52,12210,12147,63,46,52,2020-07-01
NA,佐世保市,NA,3986,3976,10,5049,5039,10,30,26,2020-07-01
NA,大分市,NA,7010,6948,62,8465,8393,72,62,56,2020-07-01
NA,宮崎市,NA,6883,6859,24,8555,8530,25,56,65,2020-07-01
NA,鹿児島市,NA,11701,11615,86,14900,14796,104,68,78,2020-07-01
NA,那覇市,NA,10243,10235,8,13096,13088,8,79,81,2020-07-01
